1,1,2,2,2,6,7,7,1,1,2
2,2,3,3,6,7,7,2,2,3,3
3,3,4,4,2,7,1,2,3,3,4
4,4,5,5,2,1,1,4,4,5,5
6,7,7,1,1,2,2,3,3,6,7
1,1,2,2,3,3,4,4,5,5,1
2,2,3,3,4,4,5,5,6,6,2
4,4,5,5,6,6,7,7,1,1,3
2,2,3,3,4,4,5,5,6,6,3
3,3,4,4,5,5,6,6,7,7,1
4,4,5,5,6,6,7,7,1,1,2
5,5,6,6,7,7,1,1,2,2,3